20,20
##################
#___#________d___#
#___#________#___#
#___#________#___#
#___#________#___#
#___#g_______#___#
#___#________#___#
#___#________#___#
#___#________#___#
##d###########fff#
#________#_______#
#________#_______#
#________#_____###
#ww#_____#_______#
#__#_____d_______#
#__#__#__#_______#
#######__###_____#
#T____#__#_______#
#_____#__#______T#
##################
START, 2, 2