10,10
##########
#________#
#________#
#______###
###______#
#______###
#g#______#
#####_####
#________#
##########
START, 5, 2